hgnc_id,hgnc_symbol,con,go_con,gene_con,rel_go,frac_rel_go
620,APP,260,64,196,13,0.203
10067,RNF4,179,14,165,10,0.714
8071,NXF1,121,9,112,8,0.889
17922,REPIN1,110,5,105,4,0.8
7765,NF1,112,15,97,10,0.667
3471,ESRRA,111,15,96,14,0.933
3778,FN1,136,40,96,36,0.9
9864,RARA,137,47,90,26,0.553
3489,ETS2,100,15,85,13,0.867
3121,E4F1,94,12,82,11,0.917
3810,FOXF2,99,18,81,11,0.611
3373,EP300,141,62,79,55,0.887
14935,SIRT7,106,34,72,29,0.853
24953,HEXIM1,85,18,67,17,0.944
9611,PTK2,115,52,63,33,0.635
12853,YWHAH,78,16,62,14,0.875
8923,PHGDH,64,2,62,1,0.5
29010,SETD1A,74,15,59,12,0.8
12036,TRAF6,104,45,59,32,0.711
25156,SGF29,65,7,58,7,1
8638,KAT2B,84,27,57,23,0.852
6116,IRF1,75,18,57,13,0.722
9884,RB1,87,34,53,31,0.912
10442,RPS9,68,17,51,10,0.588
2092,CLTC,83,33,50,25,0.758
6110,IQGAP1,84,34,50,6,0.176
9982,RFX1,56,7,49,7,1
10908,SLC11A2,90,41,49,39,0.951
9393,PRKCA,73,27,46,17,0.63
14929,SIRT1,150,105,45,72,0.686
7406,MT2A,56,11,45,6,0.545
6140,ITGA4,67,23,44,21,0.913
10852,SHMT2,80,36,44,28,0.778
10310,RPL18,54,11,43,9,0.818
9413,PRKDC,82,39,43,22,0.564
2555,CUL4B,60,18,42,18,1
2556,CUL5,50,9,41,9,1
15911,NOP56,51,11,40,11,1
2961,DYNC1H1,64,24,40,22,0.917
14063,HDAC4,79,39,40,28,0.718
9113,PML,74,34,40,20,0.588
10368,RPL8,49,10,39,8,0.8
2452,CSNK1D,65,26,39,17,0.654
16807,SMURF1,66,27,39,17,0.63
8925,PHKA1,39,1,38,1,1
10418,RPS28,50,13,37,12,0.923
9725,PYGL,52,15,37,12,0.8
9191,POLR2D,54,17,37,11,0.647
10317,RPL23A,47,10,37,6,0.6
10397,RPS17,44,8,36,7,0.875
17165,TFIP11,46,10,36,7,0.7
24818,FOXJ2,48,14,34,13,0.929
10307,RPL17,40,6,34,5,0.833
9282,PPP1CB,50,16,34,0,0
4803,HADHB,41,8,33,8,1
8927,PHKB,35,2,33,2,1
13631,RPL36,41,8,33,5,0.625
11393,AURKA,60,27,33,16,0.593
5213,HSD17B4,46,14,32,14,1
7428,MTF1,43,11,32,11,1
10344,RPL35,37,5,32,5,1
7669,NCOA2,44,12,32,10,0.833
3277,EIF3E,48,16,32,8,0.5
21948,ZNF746,45,14,31,14,1
4074,GABPB1,37,6,31,6,1
10409,RPS21,41,10,31,9,0.9
10377,RPLP2,37,6,31,5,0.833
1599,CCNT1,48,17,31,14,0.824
29381,LZTS2,36,5,31,4,0.8
2230,COPA,43,12,31,9,0.75
7605,MYO6,61,30,31,17,0.567
1516,CAT,53,22,31,10,0.455
9975,TRIM27,69,38,31,0,0
563,AP2B1,36,7,29,7,1
2372,MED23,35,6,29,6,1
10253,PTBP3,34,5,29,5,1
10771,SF3B4,39,10,29,9,0.9
403,ALDH3A2,43,14,29,12,0.857
393,AKT3,41,12,29,10,0.833
29513,AQR,40,11,29,7,0.636
3211,EEF1D,41,12,29,2,0.167
344,AHCYL1,42,14,28,13,0.929
10349,RPL38,36,8,28,6,0.75
169,ACTR2,43,15,28,10,0.667
851,ATP6V1A,37,10,27,10,1
19073,THOC2,38,11,27,8,0.727
7029,MET,59,32,27,5,0.156
4801,HADHA,34,8,26,8,1
7587,MYL6,32,6,26,6,1
18646,HSD17B12,29,3,26,3,1
1665,SCARB2,41,15,26,14,0.933
24011,ABI2,41,15,26,13,0.867
882,ATR,48,22,26,18,0.818
7411,MTA2,42,16,26,13,0.812
4648,GTF2B,53,27,26,20,0.741
26113,TCTN1,29,3,26,1,0.333
9381,PRKACB,36,10,26,3,0.3
2362,CRK,48,23,25,19,0.826
6150,ITGAV,76,51,25,24,0.471
17598,UBE2J1,32,8,24,7,0.875
4622,GSPT2,31,7,24,6,0.857
12011,TPM2,30,6,24,5,0.833
17349,PRPF4,35,11,24,9,0.818
16998,TMED10,42,18,24,14,0.778
3115,E2F3,39,16,23,16,1
29356,CEP44,31,8,23,8,1
22204,AHCYL2,26,3,23,3,1
10999,SLC27A5,36,13,23,11,0.846
946,MAGI1,35,12,23,0,0
24170,BRIX1,27,5,22,4,0.8
17083,RRS1,36,14,22,11,0.786
18734,MTREX,35,13,22,9,0.692
11098,SMARCA2,39,17,22,10,0.588
25503,RBM22,39,17,22,10,0.588
903,AXIN1,44,22,22,12,0.545
5344,ICAM1,44,22,22,8,0.364
10346,RPL36AL,28,6,22,1,0.167
4390,GNAQ,38,16,22,0,0
2326,CPSF3,28,7,21,7,1
24265,PTRH2,29,8,21,7,0.875
11450,SUCLG2,28,7,21,5,0.714
19663,GNG12,28,7,21,5,0.714
29609,ACP6,28,7,21,4,0.571
1356,ERLIN2,34,13,21,0,0
16846,WTAP,29,9,20,9,1
20194,POLR1C,27,7,20,7,1
84,ACACA,26,6,20,6,1
28396,TMEM67,31,11,20,10,0.909
396,ALAS1,30,10,20,9,0.9
12836,XRN2,35,15,20,13,0.867
11104,SMARCC1,36,16,20,13,0.812
4298,GLB1,29,9,20,6,0.667
10354,RPL41,27,7,20,4,0.571
9828,RAE1,31,11,20,6,0.545
7568,MYH10,45,25,20,13,0.52
1497,CASK,33,13,20,6,0.462
16806,UBR5,39,19,20,7,0.368
16171,CHMP4B,58,38,20,0,0
16930,CHERP,30,10,20,0,0
29931,GNL3,35,15,20,0,0
18621,COG6,23,4,19,4,1
23136,SCNM1,23,4,19,4,1
17060,KIFAP3,31,12,19,11,0.917
5724,RBPJ,39,20,19,15,0.75
2681,DAXX,54,35,19,26,0.743
6486,LAMB1,41,22,19,16,0.727
14959,RBM15,32,13,19,9,0.692
947,BAIAP2,35,16,19,10,0.625
3059,HBEGF,33,14,19,7,0.5
9388,PRKAR1A,37,18,19,7,0.389
8781,PDE4B,30,11,19,3,0.273
6142,ITGA6,36,17,19,4,0.235
11612,TCEA1,24,5,19,1,0.2
6139,ITGA3,39,20,19,2,0.1
20568,TRAM1,23,4,19,0,0
2678,DARS1,26,8,18,8,1
6936,MCCC1,24,6,18,6,1
9227,PPAN,23,5,18,5,1
2237,COPG2,26,8,18,7,0.875
15469,DNAJC6,26,8,18,6,0.75
9330,PQBP1,31,13,18,8,0.615
12593,USF1,41,23,18,14,0.609
1189,AHSA1,27,9,18,5,0.556
12791,WRN,73,55,18,30,0.545
7980,NR4A1,36,18,18,9,0.5
26212,SPCS3,25,7,18,3,0.429
25551,SMG8,21,3,18,1,0.333
3332,MARK2,42,24,18,7,0.292
18412,ZDHHC17,29,12,17,12,1
2071,CLK3,26,9,17,9,1
28107,PPCDC,23,6,17,6,1
321,AGL,22,5,17,5,1
6387,KLC1,19,2,17,2,1
6492,LAMC1,29,12,17,10,0.833
4657,GTF2H3,30,13,17,10,0.769
25515,CEP192,30,13,17,10,0.769
25907,CEP89,27,10,17,7,0.7
14405,KIF13B,29,12,17,8,0.667
11057,SLC7A1,40,23,17,13,0.565
869,ATP7A,34,17,17,9,0.529
9314,PPP3CA,40,23,17,12,0.522
4553,GPX1,40,23,17,12,0.522
6616,LIMS1,37,20,17,9,0.45
17376,AK3,27,10,17,0,0
566,AP3B1,24,8,16,8,1
13026,ZNF232,23,7,16,7,1
17293,PRKD2,51,35,16,28,0.8
15840,KMT2B,26,10,16,8,0.8
16994,OS9,26,10,16,8,0.8
21107,CEP162,21,5,16,4,0.8
2753,DECR1,25,9,16,7,0.778
4138,GANAB,26,10,16,7,0.7
11990,TOP2B,32,16,16,11,0.688
9162,PNN,22,6,16,4,0.667
30646,SND1,32,16,16,10,0.625
8877,PFKM,37,21,16,13,0.619
10606,SCP2,33,17,16,10,0.588
9618,PTK7,28,12,16,7,0.583
3367,ENTPD5,23,7,16,3,0.429
10065,TRIM39,33,17,16,1,0.059
3377,EPB41,35,19,16,0,0
10025,RLF,20,5,15,5,1
25560,RPRD1A,20,5,15,5,1
560,AP1S2,19,4,15,4,1
19095,GCC1,17,2,15,2,1
1299,YBEY,17,2,15,2,1
1399,CACNA2D1,28,13,15,12,0.923
24659,EXOC8,26,11,15,10,0.909
78,ABLIM1,22,7,15,6,0.857
15829,ELOVL6,26,11,15,9,0.818
12013,TPM4,25,10,15,8,0.8
6880,MAPK7,37,22,15,17,0.773
11076,SLC9A3R2,28,13,15,10,0.769
2323,CPS1,30,15,15,10,0.667
30587,SNIP1,24,9,15,6,0.667
1401,CACNB1,24,9,15,6,0.667
2363,CRKL,30,15,15,9,0.6
1719,CDC14B,35,20,15,11,0.55
735,ASAH1,26,11,15,6,0.545
6857,MAP3K5,43,28,15,15,0.536
9964,DPF2,31,16,15,8,0.5
8022,NT5C2,19,4,15,2,0.5
2190,COL13A1,30,15,15,7,0.467
11312,TRIM21,49,34,15,9,0.265
2385,CRY2,33,18,15,0,0
13083,ZBTB21,26,12,14,12,1
28360,DDA1,18,4,14,4,1
30685,TXLNA,17,3,14,3,1
16633,MRPS18C,17,3,14,3,1
25982,GPATCH4,16,2,14,2,1
5126,HOXC4,25,11,14,10,0.909
17284,POT1,43,29,14,26,0.897
14934,SIRT6,33,19,14,17,0.895
7863,NNT,21,7,14,6,0.857
4171,GATA2,42,28,14,21,0.75
6484,LAMA4,18,4,14,3,0.75
9871,RASA1,25,11,14,8,0.727
8984,PI4KB,23,9,14,6,0.667
6501,LAMP2,34,20,14,12,0.6
10432,RPS6KA3,25,11,14,6,0.545
9906,RBFOX2,27,13,14,7,0.538
6631,LMAN1,29,15,14,8,0.533
20907,EAF1,22,8,14,4,0.5
13759,CYFIP1,33,19,14,9,0.474
9569,PSME2,24,10,14,4,0.4
2211,COL6A1,25,11,14,4,0.364
11960,GIGYF2,31,17,14,1,0.059
17634,NUFIP2,24,10,14,0,0
8905,PGM1,21,7,14,0,0
29222,ZNF644,18,5,13,5,1
2068,CLK1,16,3,13,3,1
16654,MRPL50,15,2,13,2,1
16787,EDEM3,15,2,13,2,1
7714,NDUFS7,20,7,13,6,0.857
8653,PCCA,19,6,13,5,0.833
11585,TBL1X,33,20,13,15,0.75
8604,PAPSS2,17,4,13,3,0.75
29020,ECPAS,27,14,13,10,0.714
3267,EIF2S3,25,12,13,8,0.667
25989,CWC25,19,6,13,4,0.667
21224,ZUP1,16,3,13,2,0.667
9656,PTPN4,17,4,13,1,0.25
15842,ERBIN,29,16,13,0,0
7749,NEK6,35,22,13,0,0
18311,ERP44,24,11,13,0,0
8062,NUP153,31,18,13,0,0
8867,PFDN2,24,12,12,12,1
17615,PCGF1,23,11,12,11,1
20041,ZNF408,18,6,12,6,1
17680,RBAK,18,6,12,6,1
4667,GTF3C4,16,4,12,4,1
4115,GALC,15,3,12,3,1
25487,MED9,14,2,12,2,1
13596,FBXO25,13,1,12,1,1
6983,ME1,20,8,12,7,0.875
18398,SMARCAD1,26,14,12,12,0.857
13082,LTN1,19,7,12,6,0.857
18477,MRTO4,19,7,12,6,0.857
24343,CXXC1,24,12,12,10,0.833
30299,LRIF1,18,6,12,5,0.833
6923,MBNL1,23,11,12,9,0.818
11802,TIA1,22,10,12,8,0.8
8603,PAPSS1,17,5,12,4,0.8
19990,ANAPC4,20,8,12,6,0.75
6845,MAP2K5,15,3,12,2,0.667
5381,IDE,47,35,12,22,0.629
10671,SDCCAG8,21,9,12,5,0.556
494,ANK3,32,20,12,11,0.55
10810,SGK1,23,11,12,6,0.545
3072,DUSP6,28,16,12,8,0.5
16966,ZMYND11,22,10,12,5,0.5
30832,TRAPPC9,16,4,12,2,0.5
9315,PPP3CB,25,13,12,6,0.462
27301,CRTC2,20,8,12,3,0.375
29938,CACTIN,36,24,12,4,0.167
4043,FZD5,34,22,12,3,0.136
9766,RAB27A,37,25,12,1,0.04
994,BCL2L11,21,9,12,0,0
6074,INPP4A,18,6,12,0,0
188,ADAM10,43,31,12,0,0
21168,RHOT1,22,10,12,0,0
4319,GLI3,36,24,12,0,0
6862,MAP4,28,16,12,0,0
16666,KIF9,24,13,11,13,1
8546,P4HA1,19,8,11,8,1
9082,PLOD2,17,6,11,6,1
26273,ZNF768,16,5,11,5,1
29682,GFM2,16,5,11,5,1
21696,TSC22D4,13,2,11,2,1
4456,GPD2,12,1,11,1,1
11541,TAF7,39,28,11,22,0.786
33238,KYAT3,15,4,11,3,0.75
14857,COG5,18,7,11,5,0.714
16650,MRPL44,26,15,11,10,0.667
28291,ZNF830,17,6,11,4,0.667
91,ACADSB,17,6,11,4,0.667
3465,ESD,17,6,11,4,0.667
29064,SFI1,14,3,11,2,0.667
9407,PRKD1,50,39,11,24,0.615
12005,TPD52,18,7,11,4,0.571
67,ABCD3,27,16,11,9,0.562
117,ACO1,26,15,11,8,0.533
3046,PIGP,15,4,11,2,0.5
2483,CSTF1,15,4,11,2,0.5
3065,DUSP10,36,25,11,12,0.48
8549,BLOC1S6,24,13,11,6,0.462
9577,PSPH,20,9,11,4,0.444
18305,ATP6AP2,27,16,11,7,0.438
2897,DLC1,35,24,11,10,0.417
4296,GLA,26,15,11,6,0.4
925,B4GALT2,16,5,11,2,0.4
3522,EYA4,19,8,11,3,0.375
17812,AMOTL2,20,9,11,3,0.333
14985,LUZP1,14,3,11,1,0.333
6697,LRP5,42,31,11,9,0.29
29030,RRP8,25,14,11,1,0.071
20066,USP34,19,8,11,0,0
16867,RNF40,25,14,11,0,0
16935,ATG7,36,25,11,0,0
4926,PFDN6,19,9,10,9,1
25944,MED18,16,6,10,6,1
25679,ATG101,15,5,10,5,1
15866,MRGBP,15,5,10,5,1
11371,STAU2,14,4,10,4,1
33107,ZNF324B,14,4,10,4,1
29413,PPP1R18,11,1,10,1,1
2962,DYNC2H1,25,15,10,14,0.933
8489,ORC3,23,13,10,11,0.846
25660,TTC21B,15,5,10,4,0.8
24477,UTP3,15,5,10,4,0.8
21036,ZNF446,15,5,10,4,0.8
30836,POC1B,19,9,10,7,0.778
9284,PPP1R10,18,8,10,6,0.75
43,TAP1,33,23,10,17,0.739
29304,UVSSA,17,7,10,5,0.714
21496,ARFIP1,20,10,10,7,0.7
16396,OSBPL8,23,13,10,9,0.692
26886,RNF19B,23,13,10,9,0.692
19338,CDK19,16,6,10,4,0.667
14053,MRPL17,16,6,10,4,0.667
24531,ANAPC15,13,3,10,2,0.667
7965,NR1H2,32,22,10,11,0.5
18999,RIOK2,22,12,10,6,0.5
15684,B3GNT5,18,8,10,4,0.5
17296,RRM2B,16,6,10,3,0.5
16655,MRPL52,14,4,10,2,0.5
33100,GPX8,12,2,10,1,0.5
55,ABCC4,27,17,10,8,0.471
29865,CHMP3,31,21,10,9,0.429
9397,ZMYND8,21,11,10,4,0.364
4272,GIT1,16,6,10,2,0.333
12635,UTRN,24,14,10,0,0
11979,TOB1,22,12,10,0,0
30279,RALGPS2,11,1,10,0,0
30611,STT3B,23,13,10,0,0
26079,DENND4C,16,6,10,0,0
28883,PPA2,15,5,10,0,0
19374,NKRF,18,9,9,9,1
28880,MAGT1,17,8,9,8,1
21100,QKI,14,5,9,5,1
25017,ZNF581,13,4,9,4,1
23843,GMCL1,12,3,9,3,1
29999,CDR2L,11,2,9,2,1
1799,CDR2,10,1,9,1,1
26097,VPS37C,17,8,9,7,0.875
30327,RPP14,15,6,9,5,0.833
24595,DYNC2LI1,20,11,9,9,0.818
11958,EP400,14,5,9,4,0.8
4422,GNS,14,5,9,4,0.8
18215,PI4K2B,17,8,9,6,0.75
1493,CARS1,17,8,9,6,0.75
9853,IPO8,13,4,9,3,0.75
17839,CDC26,13,4,9,3,0.75
25751,TRAPPC11,16,7,9,5,0.714
15468,DYNLRB1,16,7,9,5,0.714
13584,FBXO5,31,22,9,15,0.682
9173,POLA1,38,29,9,19,0.655
3006,DPM2,17,8,9,5,0.625
11700,TDG,30,21,9,13,0.619
19699,PLK2,29,20,9,12,0.6
23196,EXOC6,14,5,9,3,0.6
33499,ATRIP,14,5,9,3,0.6
16281,TRIM11,21,12,9,7,0.583
21014,ANTXR1,21,12,9,7,0.583
30329,RPP38,16,7,9,4,0.571
24328,NIP7,16,7,9,4,0.571
24637,DNAJC10,24,15,9,8,0.533
11837,TLE1,24,15,9,8,0.533
2301,CPD,15,6,9,3,0.5
4927,SLC39A7,15,6,9,3,0.5
19692,NRBF2,13,4,9,2,0.5
7142,MARCKSL1,16,7,9,3,0.429
378,AKAP8,21,12,9,5,0.417
13630,TFPT,15,6,9,2,0.333
18234,MOCOS,12,3,9,1,0.333
8614,PAWR,17,8,9,2,0.25
2978,DNMT3A,22,13,9,3,0.231
14681,SPATA2,21,12,9,0,0
24035,APPL1,39,30,9,0,0
13211,ATP2C1,29,20,9,0,0
6656,LNPEP,23,14,9,0,0
25048,INTS4,14,5,9,0,0
16937,ARL6IP5,17,8,9,0,0
16038,ORMDL3,18,9,9,0,0
12729,WARS1,27,18,9,0,0
16683,OTUD7B,23,14,9,0,0
13869,LOXL3,20,11,9,0,0
13056,ZNF263,17,9,8,9,1
26818,SPTY2D1,16,8,8,8,1
238,ADCY7,14,6,8,6,1
27905,MSL1,14,6,8,6,1
11137,SNAPC4,14,6,8,6,1
29415,ZNF526,13,5,8,5,1
22962,MED13L,11,3,8,3,1
24549,MRFAP1,10,2,8,2,1
6389,KIFC1,20,12,8,11,0.917
18585,MSI2,15,7,8,6,0.857
10563,SCAMP1,14,6,8,5,0.833
29174,WASHC4,14,6,8,5,0.833
929,B4GALT6,14,6,8,5,0.833
30852,SNRNP35,14,6,8,5,0.833
28304,YIPF6,13,5,8,4,0.8
8776,PDE1C,12,4,8,3,0.75
20371,NDUFA11,12,4,8,3,0.75
9045,PLAG1,17,9,8,6,0.667
14044,MRPL51,14,6,8,4,0.667
18572,HSDL2,11,3,8,2,0.667
13606,KDM2A,22,14,8,9,0.643
29885,ICE2,19,11,8,7,0.636
11478,SURF6,16,8,8,5,0.625
5966,IL11,18,10,8,6,0.6
9090,PLS1,15,7,8,4,0.571
6984,ME2,15,7,8,4,0.571
6847,MAP2K7,26,18,8,10,0.556
6174,ITM2B,19,11,8,6,0.545
2184,COIL,21,13,8,7,0.538
9280,PPOX,14,6,8,3,0.5
1136,BTN2A1,12,4,8,2,0.5
26032,LPCAT2,15,7,8,3,0.429
12461,UBAP1,16,8,8,3,0.375
12016,TPP2,14,6,8,2,0.333
195,ADAM17,57,49,8,16,0.327
4044,FZD6,18,10,8,3,0.3
30887,TRAPPC2L,15,7,8,2,0.286
21109,FAM120B,12,4,8,1,0.25
29175,WDTC1,12,4,8,1,0.25
17063,RAB3GAP1,28,20,8,3,0.15
11131,SNAP23,26,18,8,2,0.111
16667,TMEM30A,21,13,8,1,0.077
18262,MFN1,20,12,8,0,0
14539,RNF213,21,13,8,0,0
30958,ZNF622,21,13,8,0,0
15862,SMOX,15,7,8,0,0
11135,SNAPC2,11,3,8,0,0
14422,BBX,14,7,7,7,1
13507,ZNF317,12,5,7,5,1
8829,PELO,12,5,7,5,1
13057,ZNF264,12,5,7,5,1
27815,ZNF707,11,4,7,4,1
7683,NDUFA1,11,4,7,4,1
14579,VPS45,11,4,7,4,1
21460,MIPOL1,10,3,7,3,1
23571,COBLL1,9,2,7,2,1
26800,C1orf216,8,1,7,1,1
11818,TIMM8B,8,1,7,1,1
14372,SCYL1,15,8,7,7,0.875
7821,NID1,14,7,7,6,0.857
20588,PCYOX1,13,6,7,5,0.833
13554,ATP11C,18,11,7,9,0.818
12936,ZBTB17,22,15,7,12,0.8
16862,RAPGEF5,12,5,7,4,0.8
29620,ZCRB1,11,4,7,3,0.75
21561,CEP57L1,11,4,7,3,0.75
3494,ETV5,21,14,7,10,0.714
25980,TRMT1,12,5,7,3,0.6
20466,SMC6,24,17,7,10,0.588
17641,DCLRE1B,24,17,7,10,0.588
20763,ANKFY1,23,16,7,9,0.562
31675,YTHDF2,22,15,7,8,0.533
30389,EXOC4,19,12,7,6,0.5
16259,MAML2,13,6,7,3,0.5
9797,RABIF,13,6,7,3,0.5
19876,EPC1,22,15,7,7,0.467
3012,DPYD,20,13,7,6,0.462
5193,HS2ST1,12,5,7,2,0.4
4907,HIBADH,12,5,7,2,0.4
28467,FAAP24,12,5,7,2,0.4
14490,MRPL36,12,5,7,2,0.4
13664,MACF1,29,22,7,8,0.364
17720,SGPP1,13,6,7,2,0.333
8811,PDK3,22,15,7,4,0.267
24042,WWTR1,26,19,7,5,0.263
248,PLIN2,12,5,7,1,0.2
29062,C2CD5,21,14,7,2,0.143
10023,RIT1,14,7,7,1,0.143
11984,TOM1L2,15,8,7,1,0.125
1078,BMPR2,44,37,7,1,0.027
1082,BNIP1,20,13,7,0,0
9675,PTPRM,28,21,7,0,0
28337,C9orf72,35,28,7,0,0
941,BAG5,27,20,7,0,0
16859,NOS1AP,13,6,7,0,0
598,APLP2,12,5,7,0,0
13718,FOSL1,15,9,6,9,1
4879,HEXB,14,8,6,8,1
18595,HIC2,13,7,6,7,1
13004,ZNF212,12,6,6,6,1
890,AUH,10,4,6,4,1
26006,TTC19,10,4,6,4,1
10580,SCML1,10,4,6,4,1
11694,DYNLT3,10,4,6,4,1
5004,HMGB3,10,4,6,4,1
24560,CCDC9,8,2,6,2,1
17928,PSMC3IP,8,2,6,2,1
10757,SERF2,7,1,6,1,1
30281,RGL1,7,1,6,1,1
3319,ELF4,19,13,6,12,0.923
2720,ASAP1,14,8,6,7,0.875
33279,ATXN1L,12,6,6,5,0.833
1103,BRD2,16,10,6,8,0.8
17931,SERTAD3,11,5,6,4,0.8
2938,DMXL2,11,5,6,4,0.8
15867,YTHDF1,15,9,6,7,0.778
29187,SETD1B,15,9,6,7,0.778
12500,UBE4B,14,8,6,6,0.75
25694,TBC1D15,10,4,6,3,0.75
29004,ZNF646,10,4,6,3,0.75
26994,INO80C,10,4,6,3,0.75
7135,AFF1,10,4,6,3,0.75
25769,KRI1,10,4,6,3,0.75
30025,PPRC1,13,7,6,5,0.714
25518,YJU2,9,3,6,2,0.667
19016,TRIM44,17,11,6,7,0.636
3225,EFNA5,19,13,6,8,0.615
19239,SYT11,25,19,6,10,0.526
12611,USP13,28,22,6,11,0.5
24721,YTHDC2,18,12,6,6,0.5
26428,FAAP20,18,12,6,6,0.5
25529,WDR74,14,8,6,4,0.5
28957,EMC1,14,8,6,4,0.5
9121,PMS1,12,6,6,3,0.5
29144,EHBP1,12,6,6,3,0.5
28948,TMEM41B,10,4,6,2,0.5
11442,STX7,37,31,6,15,0.484
17175,PLCE1,25,19,6,8,0.421
10293,RPE,18,12,6,5,0.417
24303,RBM15B,18,12,6,5,0.417
3233,MEGF8,16,10,6,4,0.4
190,ADAM12,11,5,6,2,0.4
327,AGPS,14,8,6,3,0.375
16230,ZCCHC3,14,8,6,2,0.25
18533,USP48,14,8,6,2,0.25
11319,ITPRID2,10,4,6,1,0.25
6710,LTA4H,20,14,6,0,0
656,ARL4D,12,6,6,0,0
18798,SLC44A1,16,10,6,0,0
28977,IST1,27,21,6,0,0
8140,OPA1,35,29,6,0,0
13949,FKBPL,8,2,6,0,0
226,ADARB1,24,18,6,0,0
2255,CORO2A,9,3,6,0,0
23158,PNRC2,12,6,6,0,0
21529,TM9SF3,8,2,6,0,0
17217,DIP2A,10,4,6,0,0
70,ABCF1,11,5,6,0,0
15625,NBAS,12,7,5,7,1
25736,ZNF669,11,6,5,6,1
8822,PEA15,10,5,5,5,1
22213,ZNF777,10,5,5,5,1
26166,ZNF574,9,4,5,4,1
4139,GANC,9,4,5,4,1
29046,FBXO28,9,4,5,4,1
4929,ZSCAN22,9,4,5,4,1
24615,EEF2K,8,3,5,3,1
18308,TMLHE,8,3,5,3,1
28796,MRFAP1L1,7,2,5,2,1
19667,WDR20,6,1,5,1,1
13075,ZNF281,20,15,5,14,0.933
23239,ZNF473,13,8,5,7,0.875
6824,MAN2A1,12,7,5,6,0.857
25714,CCDC51,10,5,5,4,0.8
19398,PGBD1,10,5,5,4,0.8
9347,PRDM2,17,12,5,9,0.75
29118,TMEM63A,13,8,5,6,0.75
25712,PGAP1,9,4,5,3,0.75
7712,NDUFS5,9,4,5,3,0.75
3492,ETV3,12,7,5,5,0.714
7449,MTMR1,12,7,5,5,0.714
21308,ELOVL5,18,13,5,9,0.692
2527,CTSB,21,16,5,11,0.688
28984,WASHC5,14,9,5,6,0.667
17304,TAF5L,14,9,5,6,0.667
25521,SRBD1,8,3,5,2,0.667
25035,YOD1,22,17,5,11,0.647
23366,ARPC5L,13,8,5,5,0.625
10994,SLC26A2,13,8,5,5,0.625
11447,STYX,15,10,5,6,0.6
26934,NOP16,10,5,5,3,0.6
8992,PIN4,10,5,5,3,0.6
17057,CARD8,26,21,5,12,0.571
7506,MTX2,12,7,5,4,0.571
25539,RFWD3,21,16,5,9,0.562
29675,CLCC1,11,6,5,3,0.5
13621,SLC6A15,11,6,5,3,0.5
15597,HPS3,9,4,5,2,0.5
30898,AVPI1,7,2,5,1,0.5
12962,TRIM26,14,9,5,4,0.444
245,ADD3,10,5,5,2,0.4
33451,CCDC137,10,5,5,2,0.4
23088,SLC10A7,18,13,5,5,0.385
17151,ORC6,13,8,5,3,0.375
21610,LNPK,16,11,5,4,0.364
23711,REEP3,14,9,5,3,0.333
12790,GET1,8,3,5,1,0.333
13632,MAML1,18,13,5,4,0.308
7754,NEO1,12,7,5,2,0.286
3574,FADS1,12,7,5,2,0.286
11580,TBCC,13,8,5,2,0.25
675,ARHGAP5,9,4,5,1,0.25
1106,BABAM2,20,15,5,3,0.2
1507,CASP6,17,12,5,2,0.167
29271,ZNFX1,8,3,5,0,0
13008,ZFAND5,6,1,5,0,0
29670,GNPTAB,12,7,5,0,0
12393,TTC3,13,8,5,0,0
8967,PIGN,11,6,5,0,0
12947,ZNF16,19,14,5,0,0
5130,HOXC9,16,11,5,0,0
24671,FLAD1,11,6,5,0,0
29520,GPBP1,11,6,5,0,0
13831,WDR11,17,12,5,0,0
10057,RNF13,15,10,5,0,0
20908,DZIP1,15,10,5,0,0
18267,FMNL2,13,8,5,0,0
24936,EEF1AKMT3,16,11,5,0,0
14897,ITPKC,12,7,5,0,0
33772,LAMTOR4,15,10,5,0,0
13518,CLIC4,26,21,5,0,0
1753,CDH13,42,37,5,0,0
12340,TRPS1,16,11,5,0,0
10731,SEMA4C,18,13,5,0,0
16854,RAPGEF2,43,38,5,0,0
24275,SCCPDH,12,7,5,0,0
29402,RNF157,14,9,5,0,0
1099,BRAP,19,14,5,0,0
18559,TFB2M,13,9,4,9,1
13068,ZNF274,12,8,4,8,1
20270,C14orf119,7,3,4,3,1
29289,RELCH,7,3,4,3,1
25657,BCORL1,6,2,4,2,1
28201,TMEM128,5,1,4,1,1
19003,SCMH1,9,5,4,4,0.8
3501,EVI5,12,8,4,6,0.75
2977,TRDMT1,8,4,4,3,0.75
7963,NR1D2,15,11,4,8,0.727
26022,TRMT10C,22,18,4,13,0.722
16006,CSRNP2,11,7,4,5,0.714
15629,B3GNT2,11,7,4,5,0.714
10295,RPGR,11,7,4,5,0.714
6780,MAFF,16,12,4,8,0.667
4019,FUT8,13,9,4,6,0.667
28332,CCDC12,7,3,4,2,0.667
27829,DPY19L4,7,3,4,2,0.667
22211,ESYT2,18,14,4,9,0.643
16398,OSBPL1A,15,11,4,7,0.636
13553,ATP11B,12,8,4,5,0.625
4371,GMEB2,12,8,4,5,0.625
5129,HOXC8,12,8,4,5,0.625
20814,ZNF436,12,8,4,5,0.625
25829,ABRAXAS1,17,13,4,8,0.615
18967,EDEM1,14,10,4,6,0.6
23498,CPNE8,9,5,4,3,0.6
28956,GPD1L,18,14,4,8,0.571
7880,CNOT4,12,8,4,4,0.5
20482,WDFY2,10,6,4,3,0.5
16873,FIG4,8,4,4,2,0.5
5201,HS6ST1,8,4,4,2,0.5
26157,WDCP,6,2,4,1,0.5
17168,RAB3GAP2,15,11,4,5,0.455
220,ADAMTS4,13,9,4,4,0.444
798,ATOX1,11,7,4,3,0.429
26954,MINDY2,14,10,4,4,0.4
16933,FEM1C,9,5,4,2,0.4
30184,PTPDC1,9,5,4,2,0.4
6508,LANCL1,10,6,4,2,0.333
19998,TNPO2,10,6,4,2,0.333
7879,CNOT3,10,6,4,2,0.333
28853,JOSD2,7,3,4,1,0.333
26184,TUT1,23,19,4,6,0.316
15465,GPHN,24,20,4,6,0.3
16835,TAOK2,28,24,4,7,0.292
14255,BRPF1,18,14,4,4,0.286
13205,STRADB,11,7,4,2,0.286
14347,BCAS3,19,15,4,4,0.267
4096,GADD45B,12,8,4,2,0.25
12014,TPMT,8,4,4,1,0.25
25904,TMTC4,8,4,4,1,0.25
18783,AKAP17A,11,7,4,1,0.143
10549,ATXN10,15,11,4,1,0.091
18649,GULP1,5,1,4,0,0
1775,CDK5R1,13,9,4,0,0
271,PARP4,18,14,4,0,0
24627,DCBLD2,9,5,4,0,0
9976,TRIM13,23,19,4,0,0
28970,EFR3A,7,3,4,0,0
9003,PITPNM1,16,12,4,0,0
20352,VCPKMT,13,9,4,0,0
17797,MAP3K20,21,17,4,0,0
19089,SLC30A5,15,11,4,0,0
29521,C12orf57,14,10,4,0,0
4119,GALK2,7,3,4,0,0
25601,WDR41,11,7,4,0,0
20080,USP45,12,8,4,0,0
1085,BNIP3L,23,19,4,0,0
20256,SFMBT2,16,12,4,0,0
11281,SRA1,22,18,4,0,0
20231,KLHDC2,8,4,4,0,0
7090,MICA,21,17,4,0,0
10249,ROBO1,23,19,4,0,0
29149,PHLPP2,13,9,4,0,0
19682,HASPIN,19,15,4,0,0
8596,PAM,13,9,4,0,0
19075,TIFA,11,7,4,0,0
17297,RNF34,22,18,4,0,0
14214,CIC,10,7,3,7,1
16017,ZNF343,10,7,3,7,1
8540,P2RY11,9,6,3,6,1
30422,SHROOM3,9,6,3,6,1
17908,ZBTB43,8,5,3,5,1
10675,SDF2,7,4,3,4,1
26673,ZSCAN29,7,4,3,4,1
13003,ZNF211,7,4,3,4,1
3298,EIF4G3,7,4,3,4,1
30863,UQCR10,6,3,3,3,1
28358,D2HGDH,5,2,3,2,1
29141,WDR47,4,1,3,1,1
26911,ZCCHC24,4,1,3,1,1
25591,CCDC25,4,1,3,1,1
16791,TSEN15,4,1,3,1,1
21074,GINM1,4,1,3,1,1
20914,BLOC1S3,11,8,3,7,0.875
4370,GMEB1,11,8,3,7,0.875
16087,SFXN3,10,7,3,6,0.857
25956,VPS50,10,7,3,6,0.857
26573,ZNF597,9,6,3,5,0.833
24009,APOOL,9,6,3,5,0.833
16469,ACAP2,8,5,3,4,0.8
23710,ZSCAN5A,8,5,3,4,0.8
12984,ZSCAN9,8,5,3,4,0.8
12994,ZNF202,12,9,3,7,0.778
25352,ZNF710,7,4,3,3,0.75
6822,MAN1A2,10,7,3,5,0.714
24967,MIS12,13,10,3,7,0.7
5974,IL13RA1,13,10,3,7,0.7
18085,TMEM199,13,10,3,7,0.7
11375,HSPA13,16,13,3,9,0.692
15508,PUS1,12,9,3,6,0.667
20756,ZFYVE16,12,9,3,6,0.667
48,ABCB7,9,6,3,4,0.667
29347,KLHL15,9,6,3,4,0.667
696,ARL5A,9,6,3,4,0.667
29129,ENDOD1,6,3,3,2,0.667
30781,TADA2B,11,8,3,5,0.625
30550,MARCHF6,18,15,3,9,0.6
25452,PIP4P2,8,5,3,3,0.6
17085,EXOC6B,8,5,3,3,0.6
20725,ZNF426,8,5,3,3,0.6
20271,NGDN,10,7,3,4,0.571
16406,EFHC1,14,11,3,6,0.545
8801,PDGFC,20,17,3,9,0.529
15765,MOCS3,15,12,3,6,0.5
20564,MBNL3,9,6,3,3,0.5
30809,TRIB2,9,6,3,3,0.5
14860,UBXN4,7,4,3,2,0.5
25788,ARMH3,7,4,3,2,0.5
30697,ITFG1,5,2,3,1,0.5
30559,RSRC2,5,2,3,1,0.5
28999,FAM168A,5,2,3,1,0.5
358,AIP,10,7,3,3,0.429
16386,OSBPL9,10,7,3,3,0.429
26907,SLC38A9,15,12,3,5,0.417
28145,YIPF4,8,5,3,2,0.4
14933,SIRT5,19,16,3,6,0.375
16943,CDC42EP3,12,9,3,3,0.333
31853,ADAL,6,3,3,1,0.333
18173,ERAP1,21,18,3,5,0.278
24905,CREBZF,14,11,3,3,0.273
29801,MOB1B,14,11,3,3,0.273
25784,DCAF17,7,4,3,1,0.25
14946,PPP1R9A,12,9,3,2,0.222
21577,KDM1B,17,14,3,3,0.214
18348,TICAM1,14,11,3,0,0
1742,LRBA,7,4,3,0,0
30418,SH3D19,10,7,3,0,0
23039,UFL1,28,25,3,0,0
10928,SLC16A7,14,11,3,0,0
30465,EMB,9,6,3,0,0
3333,EMP1,7,4,3,0,0
3164,EDF1,13,10,3,0,0
20750,ZDHHC21,12,9,3,0,0
24855,CCDC91,7,4,3,0,0
30897,VCPIP1,14,11,3,0,0
11023,SLC35A3,7,4,3,0,0
21894,PRKRIP1,11,8,3,0,0
17034,TUSC2,7,4,3,0,0
16348,ARHGAP12,10,7,3,0,0
20059,USP33,25,22,3,0,0
8764,PDCD5,19,16,3,0,0
13611,FBXL12,11,8,3,0,0
24718,TMX3,8,5,3,0,0
18551,DGCR6L,4,1,3,0,0
15882,PCMTD2,6,3,3,0,0
18537,NDFIP2,18,15,3,0,0
19883,ZBTB49,18,15,3,0,0
29800,MOB3C,4,1,3,0,0
17255,KNTC1,11,8,3,0,0
19217,THADA,8,5,3,0,0
10973,SLC23A2,12,9,3,0,0
8609,PARN,22,19,3,0,0
23326,PXK,11,8,3,0,0
24257,TMBIM4,7,4,3,0,0
363,AK4,18,15,3,0,0
7993,NRBP1,8,5,3,0,0
25309,CEP85,12,9,3,0,0
17521,ZNF385A,13,10,3,0,0
14237,GUCD1,4,1,3,0,0
24325,CDKN2AIP,13,10,3,0,0
29237,WWC3,9,6,3,0,0
25596,TTC17,10,7,3,0,0
21335,SNX13,7,5,2,5,1
12881,ZNF101,7,5,2,5,1
25112,ZNF845,6,4,2,4,1
20645,ZNF416,6,4,2,4,1
13478,UBE3B,5,3,2,3,1
17752,TSPAN3,4,2,2,2,1
19093,PSD3,3,1,2,1,1
29364,TANC1,3,1,2,1,1
19305,SLC30A6,3,1,2,1,1
30366,TMEM131,3,1,2,1,1
25090,CMBL,3,1,2,1,1
20201,FBXO34,3,1,2,1,1
23193,THAP10,3,1,2,1,1
9047,PLAGL2,8,6,2,5,0.833
28072,LYRM7,7,5,2,4,0.8
25092,ZNF765,7,5,2,4,0.8
23836,ZBTB5,10,8,2,6,0.75
25819,COQ10B,6,4,2,3,0.75
28420,KXD1,6,4,2,3,0.75
12927,ZNF142,6,4,2,3,0.75
13049,ZNF256,9,7,2,5,0.714
26498,ZNF513,9,7,2,5,0.714
7326,MSH3,27,25,2,17,0.68
53826,SHLD3,8,6,2,4,0.667
29273,HEATR5B,8,6,2,4,0.667
17073,ARHGAP26,5,3,2,2,0.667
4247,GGCX,5,3,2,2,0.667
2291,COX7B,5,3,2,2,0.667
12964,ZNF175,15,13,2,8,0.615
32310,RBM12B,7,5,2,3,0.6
20376,SUMF1,7,5,2,3,0.6
18737,ZNF395,14,12,2,7,0.583
26775,TMEM192,9,7,2,4,0.571
29643,MLPH,11,9,2,5,0.556
1908,VPS13A,14,12,2,6,0.5
28953,JOSD1,6,4,2,2,0.5
25160,KTI12,6,4,2,2,0.5
29186,ANKRD26,4,2,2,1,0.5
24530,TMEM186,4,2,2,1,0.5
29601,C17orf80,4,2,2,1,0.5
11309,SRPX,4,2,2,1,0.5
18179,VPS33A,19,17,2,8,0.471
26575,PRIMPOL,17,15,2,7,0.467
24013,DNTTIP2,7,5,2,2,0.4
9225,SLC43A1,8,6,2,2,0.333
2350,CREBL2,5,3,2,1,0.333
26928,CDV3,5,3,2,1,0.333
19166,TBC1D5,21,19,2,6,0.316
25491,FRMD4A,6,4,2,1,0.25
19911,DCAF12,6,4,2,1,0.25
18800,POGK,6,4,2,1,0.25
23049,TM7SF3,7,5,2,1,0.2
26635,DENND6A,7,5,2,1,0.2
14254,NOCT,7,5,2,1,0.2
12996,ZNF205,9,7,2,1,0.143
30130,PAQR3,10,8,2,1,0.125
20044,GEMIN6,11,9,2,1,0.111
28870,MDFIC,13,11,2,1,0.091
32554,FAM83G,8,6,2,0,0
24678,FTO,23,21,2,0,0
10698,SEC14L1,10,8,2,0,0
8965,PIGK,8,6,2,0,0
20187,ATG2B,12,10,2,0,0
13549,ATP10D,11,9,2,0,0
23595,VPS13D,8,6,2,0,0
6617,LIPA,9,7,2,0,0
24497,C15orf39,3,1,2,0,0
21035,ARHGAP18,16,14,2,0,0
24180,RPUSD2,5,3,2,0,0
21072,MANEA,4,2,2,0,0
28111,ELMOD2,5,3,2,0,0
21225,CBLL1,10,8,2,0,0
14977,SNX14,8,6,2,0,0
27880,ANKRD13D,7,5,2,0,0
21086,MIB1,10,8,2,0,0
28698,DIS3L,11,9,2,0,0
14450,LPIN2,12,10,2,0,0
13328,IFIT5,18,16,2,0,0
24731,NHLRC2,4,2,2,0,0
15569,CABYR,9,7,2,0,0
26606,METTL15,4,2,2,0,0
20331,RASA3,4,2,2,0,0
6356,KLHL5,3,1,2,0,0
3516,EXTL2,10,8,2,0,0
29106,DDHD2,8,6,2,0,0
15456,MBTPS1,7,5,2,0,0
6953,CD46,19,17,2,0,0
26887,TAPT1,7,5,2,0,0
20910,AFMID,6,4,2,0,0
969,BBS4,27,25,2,0,0
3094,DYRK3,25,23,2,0,0
21114,C6orf89,12,10,2,0,0
30890,URGCP,3,1,2,0,0
10823,SH3BGRL,4,2,2,0,0
25789,EFL1,8,6,2,0,0
30204,C11orf54,9,7,2,0,0
1171,ELP4,11,9,2,0,0
25240,ANO6,33,31,2,0,0
20488,L3HYPDH,3,1,2,0,0
2893,DKK3,11,9,2,0,0
21166,RHEBL1,11,9,2,0,0
25276,PUS7L,6,4,2,0,0
15876,TMEM230,8,7,1,7,1
28632,ZNF557,6,5,1,5,1
12863,ZFP37,6,5,1,5,1
11568,TARBP1,3,2,1,2,1
29507,SCPEP1,3,2,1,2,1
19334,DTWD2,3,2,1,2,1
16105,OSER1,2,1,1,1,1
21556,NT5DC1,2,1,1,1,1
25799,GUF1,2,1,1,1,1
28486,MFSD8,2,1,1,1,1
27329,R3HCC1,2,1,1,1,1
19399,PGBD2,2,1,1,1,1
24641,VPS35L,6,5,1,4,0.8
26135,ZNF552,6,5,1,4,0.8
19687,EIF2AK4,9,8,1,6,0.75
17291,TMED1,9,8,1,6,0.75
25108,ZNF551,5,4,1,3,0.75
32034,ZNF697,5,4,1,3,0.75
27994,ZNF850,5,4,1,3,0.75
33105,ZNF468,5,4,1,3,0.75
14209,ZNF329,5,4,1,3,0.75
38695,ZNF888,5,4,1,3,0.75
23272,ZNF805,5,4,1,3,0.75
16855,TRAM2,5,4,1,3,0.75
13073,ZNF28,5,4,1,3,0.75
28635,GK5,8,7,1,5,0.714
18969,IL31RA,11,10,1,7,0.7
7091,MICB,11,10,1,7,0.7
13588,FBXO9,7,6,1,4,0.667
29786,SLC25A37,4,3,1,2,0.667
16656,ZNF350,15,14,1,9,0.643
23576,HOOK3,20,19,1,12,0.632
12879,ZNF10,9,8,1,5,0.625
25640,UFSP2,6,5,1,3,0.6
20649,ZNF420,6,5,1,3,0.6
13501,ZNF286A,6,5,1,3,0.6
13644,ZNF319,6,5,1,3,0.6
12867,ZKSCAN5,6,5,1,3,0.6
13022,ZNF229,6,5,1,3,0.6
23440,ZNF485,6,5,1,3,0.6
29477,LEPROT,10,9,1,5,0.556
19863,SLC38A6,7,6,1,3,0.5
16764,ZBTB6,7,6,1,3,0.5
16719,DHX34,7,6,1,3,0.5
22205,DPY19L1,5,4,1,2,0.5
26054,SLC25A38,5,4,1,2,0.5
29177,MON2,3,2,1,1,0.5
28159,GFOD2,3,2,1,1,0.5
27607,PPP1R37,3,2,1,1,0.5
23512,R3HCC1L,3,2,1,1,0.5
26145,LDAH,3,2,1,1,0.5
18333,TIGD2,3,2,1,1,0.5
6200,JRKL,3,2,1,1,0.5
29013,CLEC16A,14,13,1,6,0.462
7162,MMP16,10,9,1,4,0.444
7760,NEU3,18,17,1,7,0.412
20730,ARMC9,6,5,1,2,0.4
25461,PUS3,6,5,1,2,0.4
11731,TESK1,14,13,1,5,0.385
2021,CLCN3,23,22,1,8,0.364
20273,EMC9,7,6,1,2,0.333
29370,ITPRIP,4,3,1,1,0.333
29134,DENND3,4,3,1,1,0.333
19178,CMTM7,4,3,1,1,0.333
23994,ERI1,8,7,1,2,0.286
25203,TMEM65,5,4,1,1,0.25
11980,TOB2,7,6,1,1,0.167
29944,TENM3,8,7,1,1,0.143
2000,CKS2,9,8,1,1,0.125
28404,DENND1B,10,9,1,1,0.111
30238,WLS,17,16,1,1,0.062
17313,IP6K2,17,16,1,0,0
21407,AKIRIN2,10,9,1,0,0
15807,ZNF335,14,13,1,0,0
13615,FBXL17,16,15,1,0,0
24868,IRGQ,2,1,1,0,0
16934,FEM1A,6,5,1,0,0
9590,PTER,4,3,1,0,0
26051,HPF1,9,8,1,0,0
31088,ALG10B,9,8,1,0,0
28658,AMMECR1L,2,1,1,0,0
28971,SPIDR,13,12,1,0,0
33482,MEX3A,4,3,1,0,0
16811,TUBD1,9,8,1,0,0
18469,ZDHHC2,14,13,1,0,0
19008,KLHL11,2,1,1,0,0
28458,PRR14,3,2,1,0,0
30220,RFT1,4,3,1,0,0
16157,ZSWIM3,2,1,1,0,0
25365,FAM172A,6,5,1,0,0
16992,LRRC8D,12,11,1,0,0
30926,DTWD1,4,3,1,0,0
15956,SLC2A13,11,10,1,0,0
23038,LMBRD1,9,8,1,0,0
25241,TCAIM,2,1,1,0,0
9768,RAB28,7,6,1,0,0
20498,DGLUCY,4,3,1,0,0
20278,NUBPL,8,7,1,0,0
27302,IBA57,6,5,1,0,0
28229,LLPH,7,6,1,0,0
13267,DEXI,2,1,1,0,0
28422,TSEN2,9,8,1,0,0
30483,PCMTD1,4,3,1,0,0
26004,LRRC40,7,6,1,0,0
27915,C1orf174,3,2,1,0,0
4837,HCCS,7,6,1,0,0
28295,CCDC32,2,1,1,0,0
25851,GINS3,5,4,1,0,0
26112,RTL10,5,4,1,0,0
13061,ZNF268,18,17,1,0,0
30060,NOMO1,3,2,1,0,0
28769,DRAM2,8,7,1,0,0
17808,ZC3H4,5,4,1,0,0
18536,HELQ,6,5,1,0,0
14163,FAM234A,3,2,1,0,0
21317,DYM,7,6,1,0,0
26558,HYLS1,10,9,1,0,0
24586,METTL9,2,1,1,0,0
23434,CCNJ,8,7,1,0,0
25559,RESF1,2,1,1,0,0
24351,PHRF1,2,1,1,0,0
32783,ZNF749,5,5,0,5,1
26944,TMEM138,2,2,0,2,1
28449,C11orf95,1,1,0,1,1
29036,SLC25A44,1,1,0,1,1
20874,ZNF440,6,6,0,5,0.833
24722,ZNF614,6,6,0,5,0.833
26479,ZNF778,6,6,0,5,0.833
12925,ZNF140,9,9,0,7,0.778
18832,ZNF394,4,4,0,3,0.75
13182,ZNRD1,4,4,0,3,0.75
13001,ZNF182,4,4,0,3,0.75
29297,ZNF530,4,4,0,3,0.75
24740,ZNF615,4,4,0,3,0.75
25292,ZNF700,4,4,0,3,0.75
25577,RAVER2,4,4,0,3,0.75
27309,DHFR2,11,11,0,8,0.727
19336,SHPRH,6,6,0,4,0.667
23715,ZBTB45,6,6,0,4,0.667
13160,ZNF85,6,6,0,4,0.667
26801,COX18,8,8,0,5,0.625
21629,ZNF461,5,5,0,3,0.6
12918,ZNF134,5,5,0,3,0.6
29014,ZBTB39,5,5,0,3,0.6
13024,ZNF230,5,5,0,3,0.6
28167,ZNF670,5,5,0,3,0.6
33104,ZIK1,5,5,0,3,0.6
13111,ZNF45,5,5,0,3,0.6
24737,ZNF569,5,5,0,3,0.6
26765,ZNF776,5,5,0,3,0.6
30227,SPPL2A,16,16,0,9,0.562
24285,RMDN1,4,4,0,2,0.5
25704,ZSWIM4,2,2,0,1,0.5
2937,DMXL1,2,2,0,1,0.5
25455,TSR2,2,2,0,1,0.5
11895,TNFAIP2,5,5,0,2,0.4
13841,ADGRG6,12,12,0,3,0.25
25104,AP5B1,4,4,0,1,0.25
28496,POGLUT3,5,5,0,1,0.2
25249,ZRANB3,13,13,0,2,0.154
25891,CBR4,14,14,0,1,0.071
3768,FMN1,4,4,0,0,0
28074,COX19,6,6,0,0,0
25225,ARRDC2,5,5,0,0,0
12385,PHLDA2,2,2,0,0,0
5393,IER5,11,11,0,0,0
13243,LMBR1,4,4,0,0,0
13505,ZNF304,17,17,0,0,0
25913,TMEM87B,4,4,0,0,0
26929,C15orf41,4,4,0,0,0
25589,SEPTIN11,10,10,0,0,0
11865,TM9SF2,3,3,0,0,0
16034,BIVM,2,2,0,0,0
20958,TMEM181,2,2,0,0,0
24892,CASC4,1,1,0,0,0
16014,CASD1,3,3,0,0,0
23377,FOCAD,2,2,0,0,0
27393,TMCO4,1,1,0,0,0
21239,CCDC167,1,1,0,0,0
24604,COA4,2,2,0,0,0
7526,MMUT,12,12,0,0,0
28073,ZFAND2A,1,1,0,0,0
15848,SEPTIN6,11,11,0,0,0
14349,SEPTIN10,9,9,0,0,0
25720,GPATCH3,8,8,0,0,0
17870,INVS,4,4,0,0,0
1632,CD164,7,7,0,0,0
50696,PIGBOS1,3,3,0,0,0
20792,SLC35A5,2,2,0,0,0
10806,SGCB,2,2,0,0,0
30449,PTAR1,2,2,0,0,0
28648,DIS3L2,14,14,0,0,0
20749,ZDHHC20,12,12,0,0,0
24227,CCPG1,5,5,0,0,0
26091,TRMT12,4,4,0,0,0
25545,IQCC,1,1,0,0,0
17840,CHCHD5,1,1,0,0,0
13169,ZNF93,7,7,0,0,0
28460,HROB,5,5,0,0,0
48955,UMAD1,1,1,0,0,0
28787,RILPL2,6,6,0,0,0
12974,RNF113A,11,11,0,0,0
25154,SMIM12,1,1,0,0,0
15991,LMLN,4,4,0,0,0
26877,CKAP2L,3,3,0,0,0
21302,KCTD11,2,2,0,0,0
24113,ATP13A3,2,2,0,0,0
28171,HDHD3,3,3,0,0,0
30103,C16orf72,1,1,0,0,0
28859,HILPDA,12,12,0,0,0
10752,SELENOW,2,2,0,0,0
23305,ZNF480,7,7,0,0,0
7469,MTRF1,2,2,0,0,0
18413,ZDHHC13,6,6,0,0,0
31412,SWI5,5,5,0,0,0
15892,PRELID3B,3,3,0,0,0
26115,EXO5,6,6,0,0,0
25087,FAM114A1,4,4,0,0,0
